###########
#.........#
#.#######.#
#.#######.#
#.#######.#
#.#######.#
#.#######.#
#.#######.#
#....@....#
#.........#
###########