###########
#.........#
#...###...#
#....#.@..#
#....#....#
#..#####..#
#..#...#..#
#...#.#...#
#....#....#
#.........#
###########